%%%%%%%%%%%%%%%%%%%%%%%%%%%%%%%%%%%%%%%%%%%%%%%%%%%%%%%%%%%%%%%%%%%%%%%%%%%%%%%%%%%%%%%%%%%%%%%%%%%%%%%%%%%%%%%%%%%%%%%%%%%%%%%%%
%       %   %         %   %       %       %   %     %           %   %         %     %       %     %       %   %       %       % %
% %%%%% % % % %%%%%%% % % % % %%% % %%%%% %%% % % %%% %%%%% %%% % % %%% % %%% % %%% %%% %%%%% % % %%%%% % % % % % %%% %%%%% % % %
%   %   % % % %     % % %   % %   % %   % %   % %     %   % % % % %   % %   %   % %   %   %   % %       % % % % % %       % % % %
% % % %%% % % %%% %%% % %%%%% % %%% %%% % % %%% %%%%%%% %%% % % % %%% %%%%% %%%%% %%% %%% % %%% %%%%%%%%% % % %%% %%%%%%% % % % %
% % %   % % % %   %   % %   % %   %   % % %   %   %       % % % % % %     % % %       %   % % % %       %   %   %       %   %   %
% % %%% % % % % % % %%% % % % %%% %%% % % %%% %%% %%% %%% % % % % % %%%%% % % % %%%%%%% % % % % % %%%%%%%%%%%%% % %%%%% % %%%%% %
% % % % % % %   % %       % %   %     % %   %   %   %   % % %     %   %   % % % %   %   % %   % %     %         % %     % %   % %
%%% % % % % %%% %%%%%%%%%%%%% % %%%%%%% %%% % %%%%% %%% % % % %%%%%%% % %%% % % %%% % % %%%%% % %%% % % %%%%%%%%% % %%% %%% % %%%
%   %     % %   %           % % %   %     % %     %   % % % % %     %   %   %     %   %       %   % % %   %     % % %   %   %   %
% %%%%%%%%% % %%% %%%%%%%%% %%% % % %%%%% % %%% % %%% %%% % %%% %%% % %%% % %%%%% %%%%%%%%% %%%%% % % %%% % %%% % % %%% % %%%%% %
%       % % %   % %       %     % %       %     %   %     %   % % % %     % %   % %       %   %   % %   % %   % % %   % % %   % %
% %%%%% % % %%% % % %%%%% %%%%%%% %%%%% %%%%%%%%%%% %%%%% %%% % % % % %%%%%%% % % % %%%%% %%% % %%% % %%% %%%%% % %%% %%% % % % %
%   %   %     % % % %   %   %     %   % %   %     % %   % % %   % % % %   %   % %   %   %   % % %   %         %   %   %   % %   %
%%% % %%%%%%% %%% % %%% % %%% %%% % % % % % % %%% % %%% % % %%%%% % %%% % % %%% %%%%% % %%% %%% %%%%%%%%%%%%% %%%%% %%% %%% %%% %
%   % %     % %   %   % %   % % %   % % % %   %   %     %     %   % %   % % %   %     %   %   %           %       %   % %   %   %
% %%% % %%% % % %%%%% % %%% % % %%%%% %%% %%%%% % %%% %%%%%%% %%% % % %%% % % %%% %%% %%% %%% %%%%% %%%%% %%%%%%% % % % % %%% %%%
%   %   %   %   %   % %   %       % %     % %   %   % %     % %   %   %   % % % %   %   %   %     % %   %     %   % %   %   %   %
%%% %%%%% %%%%%%% % % % % %%%%%%% % %%%%%%% % %%%%%%% % %%% % % %%%%%%% %%% % % %%% %%% %%%%%%%%% %%% % %%%%% % %%% %%%%%%% %%% %
% % %   % %       % %   % %   %             %         % % %   % %   %   %   % %       %   %       %   %   %   % % % %     %   % %
% % % %%% % %%%%%%% %%%%% % % %%%%%%%%%%%%% %%%%%%%%%%% % %%%%% % % % % % %%% %%%%%%%%%%% % %%%%%%% %%%%% % %%% % % % %%%%%%% %%%
%   %   % % %   %   % %   % % %           %   %       % %   %   % %   % %   %   %       %   %       %   %   % % % % %       %   %
% %%%%% % % %%% % %%% % %%% % % %%%%%%%%% %%%%% %%%%% % % % % %%% % %%%%%%% %%% % %%%%% % %%% %%%%%%%%% %%%%% % % % %%%%%%% %%% %
% %     % %   % % %       % %   %       % %     %   % %   %   %   % %       % %   %     % %   %     %   %     % % % %       %   %
% % % %%% %%% % % %%%%%%%%% %%%%% %%%%%%% % %%%%% % % %%%%%%% % %%% % %%%%%%% %%%%% %%%%% %%% % %%% % % % %%% % % % % %%%%%%% %%%
% % % %   % % % %     %   %   %         %   %   % % %     %   %   % % %           % %       %   %   % % %   %   %   %   %   %   %
% % % % % % % % %%%%% % % %%% %%%%%%%%% %%%%% % % % %%% %%% %%%%% %%% % %%%%%%% % % %%%%%%% %%%%% %%% %%%%% %%%%% %%%%% % % %%% %
%   % % %   % %     %   %   % %   %       %   %   % %   %   %   %   % %   % %   % %   %   %       %         %   % %     % % %   %
%%%%%%% % %%% %%%%% %%%%% % % % % % %%%%% % % %%%%%%% %%% %%%%% %%% % %%% % % %%% %%% % % % %%%%%%% %%%%%%% %%% % % % %%% % % % %
%   %   % %   %   %     % % %   %   % %   % %     %   %   %   %   %   %     %   %   %   % % %   %     %   %   % % % %   % %   % %
% % % %%% % %%% % %%% % % %%%%%%%%%%% % %%%%%%%%% % %%% %%% % % % %%%%%%%%% %%% %%% %%%%% %%% % %%%%%%% % %%% % % %%%%% % %%%%% %
% %   % % % %   %   % % %             % %         %     %   %   % %     %     %   %   %   %   %         %   % % %     % % %     %
% %%%%% % % % %%%%% % % %%%%%%%%%%% %%% % % %%%%%%%%%%%%% % %%%%%%% % % %%%%%%%%% %%%%% %%% %%%%%%%%%%% %%% % % %%%%% % % %%%%%%%
%   %     %   % %   % %   %       %     % %           %   % %       % % %       %   %   %     %       %   % % %         % %     %
% % %%%%%%%%%%% % %%%%% % % % %%%%%%%%%%% %%%%%%% %%% %%%%% % %%%%%%% % % %%%%% %%% % %%% %%%%% %%%%% %%%%% % %%%%%%%%%%% % %%% %
% %             %     % % % %           %   % %   %       %       %   %   %   %   % %     %     %         % % %           %   % %
% %%%%%%%%% %%%%%%%%% % %%% %%%%% %%%%% %%% % % %%%%%%%%% %%%%%%% % %%%%%%% %%%%% % %%%%%%% %%%%%%%%%%%%% % % % %%%%%%%%% %%% % %
%   %   % %         % % %   % %   %   %   %   %       % %       % % %   %         %       %       %   % %   %   %       % %   % %
%%% % % % %%%%% %%%%% % % %%% % %%% %%%%% %%% %%%%%%% % %%%%%%% %%% % % % %%%%%%%%%%%%% % %%%%%%% % % % %%%%%%%%% %%%%%%% % %%% %
% % % %     %   %   % % % %   % %   %     % % %   % % %       %     % % %     %         %       %   % %               %   % % % %
% % % %%% %%% % % % % % % % %%% % % % %%%%% % % % % % %%% %%% %%%%%%% % %%%%% %%% % %%%%% %%%%%%%%% % %%% %%%%%%%%%%% % %%% % % %
%   %   % %   % % %   %     %   % % %     % %   %   %   %   %   %     %     %   % % %   % %       % %   %   %     %   % % % % % %
% %%%%% % % % %%% %%%%% %%%%% %%% %%%%%%% % %%%%%%% %%% %%%%% % % %%%%% %%%%%%% %%% % % %%% %%%%% % %%% %%% % % %%% % % % % % % %
%       % % % %   %     % %   % %         %           % %     % %   %   %     %     % %     %   % % %   %   % % %   % %   % % % %
%%% %%%%% % % % %%% %%%%% % %%% % %%%%%%%%%%%%%%%%%%%%% % %%%%%%%%% % %%% % %%%%% %%% %%%%%%%%% % % % %%% %%% %%% %%%%%%% % % % %
%   %   % % % %   %     % % %   %   %             %     % %         %     %     % %   %         % % %   % %     %     %   %   % %
% %%% % %%% % %%% %%%%% % % % %%%%% %%%%% %%%%%%% % %%%%% % %%%%%%%%%%%%%%%%% %%% % %%%%% % %%%%% %%% % % %%%%% %%%%% % %%% %%% %
% %   %     %   %   %     % % %   %       %     %   % %   %   %   %     %   %     %     % % %   %   % % %           %   %   %   %
% % %%%%%%%%%%% %%% %%%%%%% % % % %%%%%%%%% %%%%%%%%% % % %%% % % % %%%%% % %%%%%%%%% % % %%% % %%% %%% %%%%%%%%%%% %%%%% %%% % %
% %       %   %   %   %     %   % %         %       %   %   % % %   %     %         % % % %   %     %   %     % %       %   % % %
% %%%%%%% % %%%%% %%% % %%%%%%%%% % % %%%%% % %%% % % %%%%% % % %%% % %%%%%%%%%%%%% %%% % % %%%%%%%%% %%% %%% % % %%%%%%%%% % %%%
% %       %         % %   %       % % %     %   % % %   % % % % %   %     %       %   % %   %       %     % % %     %   %   %   %
%%% %%%%%%%%% %%%%%%% %%% % % %%%%% % %%%%%%%%% % % %%% % % % % % %%%%%%% %%% %%% %%% % % %%% %%%%% % %%%%% % %%%%%%% % % %%%%% %
%   %       %     %   %   % %       %   %       % % %     % %   % %     %   % % % % % % % %       % %     % %     %   %   % %   %
% %%% %%%%% %%%%% % %%% %%% %%%%%%%%%%% % %%%%%%% %%% %%%%% %%% %%% %%%%%%% % % % % % % % %%%%%%% % %%%%% % %%%%% % %%%%%%% % % %
% %   %   % %     % %     %   %     % %   %     % %   %   %     %   %       % %     %   % %       %   % %       % %   % %   % % %
% % %%% % % %%%%%%% %%%%% %%% % %%% % %%%%% %%% % % %%% % %%% %%% %%%%% %%%%% %%%%% %%%%% % %%%%%%%%% % %%%%% %%% %%% % % % % % %
% %   % %   %       %     %   % % %   %   %   %   %   % %   %   % %     %     %   % %     % %       % %       %     % %   % % % %
% % %%% %%% % %%%%%%% %%%%% %%% % %%% % % %%% %%%%%%% % %%% %%%%% % %%%%% %%%%% % %%% %%%%% % %%%%% % %%%%%%%%% %%%%% %%%%% % %%%
%   %   %   % %         % % %   %   % % % %   %     % % % % %     % %     %   % %     %           % %         % %   %       %   %
% %%% %%% %%% % %%%%%%% % % % %%% % % % %%% %%% %%% % % % % % %%%%% %%%%% % % % %%%%%%% %%%%%%% %%% %%%%%%%%% % % % % %%%%% %%% %
% % %   % %   % %   %   % %   %   % %   %   %   % %   % % %   %   %     % % % % %   %   %     % %   %     %   %   %   %   %   % %
% % %%% %%% %%%%% % % %%% %%%%% %%% %%% % %%% %%% %%%%% % %%%%% % %%%%% % % % % % % %%%%% %%% %%% %%% % %%% %%%%%%%%%%% % %%%%% %
%.%               %   %           %     %             %         %       %   %     %       %       %   %                 %      P%
%%%%%%%%%%%%%%%%%%%%%%%%%%%%%%%%%%%%%%%%%%%%%%%%%%%%%%%%%%%%%%%%%%%%%%%%%%%%%%%%%%%%%%%%%%%%%%%%%%%%%%%%%%%%%%%%%%%%%%%%%%%%%%%%%