%%%%%%%%%%%%%%%%%%%%%%%%%%%%%%%%%%%%%%%%%%%%%%%%%%%%%%%%%%%%%%%%%
%   %         %   %           %                 %   %           %
%%% % % % %%%%% % % % %%%%%%% %%%%%%% %%% %%%%% % % % % %%%%%%% %
%   % % % %   % %   % %     % %     % %   %   % % %   %   % %   %
% %%% % % % % % %%%%% %%%%% % % %%% %%% %%% % % %%%%%%%%% % % %%%
% %   % % % % % %   %     % %   % % %   % % % % %         % % % %
% % %%% %%% % % % % %%%%% % %%%%% % % %%% % % % % %%% %%%%% % % %
% % %   %   %   % %   %   %       %   %     %   %   % %   %   % %
% % % % % %%%%%%%%%%% % %%%%%%%%% %%%%% %%%%%%%%%%% %%% % % %%% %
% % % % % %       %   %   %   %       % %       %   %   % % %   %
% % % % % %%% %%% % % %%% %%% % %%%%%%% % %%%%% % %%% %%% % %%% %
%   % % %   % % %   % % % %   %       % % %   % % %   %   %     %
% %%% % %%% % % %%%%% % % % %%%%% %%% % % %%% % % % %%% %%%%%%% %
% % % %   % % %   %     % %     % % %   % %   % %   %   % %     %
% % % %%%%% % % %%% %%%%% %%%%% % % %%%%% % %%% % %%% %%% % %%%%%
%   %     %   % %   % %     %   %         % %   % %   % %   %   %
%%% %%%%% %%%%% % %%% % %%%%% %%%%%%%%%%%%% % %%%%% %%% % %%% % %
% %     %       %   % %     % %     % %   %   %     %     %   % %
% %%%%% %%%%%%% %%% % %%%%% % %%% % % % % % %%% %%%%% %%%%% %%% %
%     % %     %   %   %     %   % % %   % %     %   %       %   %
%%%%% % %%%%% % %%%%% % %%%%%%% % % %%% % %%%%%%% % %%%%%%%%% %%%
%     % %   % %       %       %   %   % %   %     %         %   %
% % %%% % % % %%%%%%%%%%%%% % %%%%%%% %%%%% % %%%%%%% %%%%% %%% %
% % %   % %       %       % % %       %   %     %   % %   %   % %
% % % %%% %%%%%%% %%%%%%% % % % %%%%%%% % %%%%% %%% % % % %%% % %
% % %     % %   %         % % %     %   %   % %     % % %   % % %
% % %%%%%%% % % %%%%%%%%% % %%%%%%% %%% %%% % %%% %%% % %%% % % %
% %         % %         % %       %     %   %     %   %   %   % %
% %%%%%%%%%%% % %%%%%%% % %%%%%%% %%%%%%% %%% %%%%% %%%%%%%%%%% %
% %       %   %   %   % %     % %   %     %   %   % %   %       %
% % %%%%% % %%%%% % % %%%%%%% % %%% % %%%%% %%%%% % % % % %%%%%%%
%.      %       %   %             %   %           %   %        P%
%%%%%%%%%%%%%%%%%%%%%%%%%%%%%%%%%%%%%%%%%%%%%%%%%%%%%%%%%%%%%%%%%