%%%%%%%%%%%%%%%%%
%     %     %   %
% %%% % %%% % %%%
% %   % %   %   %
% % %%% % %%%%% %
% % %   %       %
% % % %%%%%%%%% %
% % %     %   % %
% % %%%%% % %%% %
% %       %     %
% %%%%%%%%% %%% %
% % %       % % %
% % % %%%%%%% % %
% %   %       % %
% %%%%% %%%%%%% %
%.%P            %
%%%%%%%%%%%%%%%%%